NO ./textures/hres_xpm/red_brick.xpm
SO ./textures/hres_xpm/brick_german_flag.xpm
WE ./textures/hres_xpm/stones.xpm
EA ./textures/hres_xpm/wood.xpm
F 220,100,0
C 15,219,239

1111111111111111111111111111111111111111111111111111111111111111111111111111111111111111111111111111
1S00000000000000000000000000000000000000000000000000000000000000000000000000100000000000000000000001
1000000000000000000000000000000000000000000000000000000000000000000000000000100000000000000000000001
1000000000000000000000000000000000000000000000000000000000000000000000000000100000000000000000000001
1000000000000000000000000000000000000000000000000000000000000000000000000000100000000000000000000001
1000000000000000000000000000000000000000000000000000000000000000000000000000100000000000000000000001
1000000000000000000000000000000000000000000000000000000000000000000000000000100000000000000000000001
1000000000000000000000000000000000000000000000000000000000000000000000000000100000000000000000000001
1000000000000000000000000000000000000000000000000000000000000000000000000000100000000000000000000001
1000000000000000000000000000000000000000000000000000000000000000000000000000100000000000000000000001
1000000000000000000000000000000000000000000000000000000000000000000000000000100000000000000000000001
1000000000000000000000000000000000000001100000111111110000000000000000000000100000000000000000000001
1000000000000000000000000000000000000011000000000000010000000000000000000000100000000000000000000001
1000000000000000000000000000000000001100000000000000010000000000000000000000100000000000000000000001
1000000000000000000000000000000000011000000000011111110000000000000000000000100000000000000000000001
1000000000000000000000000000000000111111111000010000000000000000000000000000100000000000000000000001
1000000000000000000000000000000000000001100000010000000000000000000000000000100000000000000000000001
1000000000000000000000000000000000000001100000011111111000000000000000000000100000000000000000000001
1000000000000000000000000000000000000000000000000000000000000000000000000000100000000000000000000001
1000000000000000000000000000000000000000000000000000000000000000000000000000100000000000000000000001
1000000000000000000000000000000000000000000000000000000000000000000000000000100000000000000000000001
1000000000000000000000000000000000000000000000000000000000000000000000000000100000000000000000000001
1000000000000000000000000000000000000000000000000000000000000000000000000000100000000000000000000001
1000000000000000000000000000000000000000000000000000000000000000000000000000100000000000000000000001
1000000000000000000000000000000000000000000000000000000000000000000000000000100000000000000000000001
1000000000000000000000000000000000000000000000000000000000000000000000000000000000000000000000000001
1111111111111111111111111111111111111111111111111111111111111111111111111111111111111111111111111111