NO ./textures/hres_xpm/red_brick.xpm
SO ./textures/hres_xpm/brick_german_flag.xpm
WE ./textures/hres_xpm/stones.xpm
EA ./textures/hres_xpm/wood.xpm
F 220,100,0
C 15,219,239



111111111111111111111111111111111111111111111
1E0000100010000010000000100000000010100000001
111010101010111010111011101110111010111011101
100010001010101010001000001010100000000011101
101011101111101011111110101011101111111111101
101010101000000000100000101000101000100011101
101110111111111110101111101011111110101011101
101010100010000010100000100000101000001011101
101010101011101110111010111111101111111011101
100000101010000010000010101000100010000011101
101010101111111011101111101011111010111011101
101010000000100000100000000000100000001011101
111010101111101110101010111011101111111111101
101010100000001000001010001000001000000011101
101011101110101110101011111111101011111011101
100010000010100010101010000000100000101000001
101110111011101010111110111011101110101011111
101000100010101010000010001000100010101000001
101110101010111011111010111011111010101011011
101000101010001010001000001000101010100011011
101110101011101011101010111111101110111011011
101010101000001010000010001000100010101011011
101011101011111111101011111011101010101011011
100010001000100000001000100000101010101011011
101010111010101011111111101111101110101111011
101010100010101000000000001000001000100011011
101010111110111111111111101011111111111011011
101010001010000010000010001010000010000011011
111011101011111110101111101010101110111111011
100010000000100000101000100000101000000011011
101111111110111010101011111111101111111011011
101000000010000010100000100000100010100011011
111010101111101110111110101111111010101011011
100010101000001000000010101000001000101011011
101011101010111011111011101011101110101111011
101010001010100000100000100010000000100011011
101010111010101110111111111110101110101011011
101010000010101010000000000010100010001011011
101011111110101010111011111010111011111011011
101000001000100010100000001010100000001011011
111111111111111111111111111111111111111111111