NO ./textures/redbrick.png
SO ./textures/bluestone.png				

WE ./textures/purplestone.png

EA ./textures/eagle.png

F 81,81,81
C 120,120,120

111111111111111111
100000000111110001
100000000011000001
100000000011000001
100000000000000001
10000000N000000001
100000000000000001
100000000000000001
100000000000000001
100000000000000001
100000000000000001
111111111111111111
