NO ./textures/hres_xpm/brick_german_flag.xpm
SO ./textures/hres_xpm/red_brick.xpm
WE ./textures/hres_xpm/red_brick.xpm
EA ./textures/hres_xpm/red_brick.xpm
D ./textures/hres_xpm/door.xpm
G ./sprites/gun/pistol_0.xpm

F 81,81,81
C 120,120,120

11111111111111111111111111111
100000000011000000000000D0001
1011000001110000000000001000111
100D000000D0000000000000100000D
1D11000001110000000000001000111
10012100001100000111011110001
11110111111111011100000010001
1111D111111111011111D1111D111
11000000110101D11100000010001
10000000000000001100000010001
1000N000000000001100010000001
11111111111111111111111111111
