NO ./textures/hres_xpm/red_brick.xpm ./textures/hres_xpm/brick_german_flag.xpm  ./textures/hres_xpm/stones.xpm ./textures/hres_xpm/german_flag.xpm
SO ./textures/hres_xpm/red_brick.xpm ./textures/hres_xpm/brick_german_flag.xpm  ./textures/hres_xpm/stones.xpm ./textures/hres_xpm/german_flag.xpm
WE ./textures/hres_xpm/red_brick.xpm ./textures/hres_xpm/brick_german_flag.xpm  ./textures/hres_xpm/stones.xpm ./textures/hres_xpm/german_flag.xpm
EA ./textures/hres_xpm/red_brick.xpm ./textures/hres_xpm/brick_german_flag.xpm  ./textures/hres_xpm/stones.xpm ./textures/hres_xpm/german_flag.xpm
D ./textures/hres_xpm/door.xpm
F 81,81,81
C 120,120,120

334343343434343333434343434343434343434343
300000D00G00000D0GGGGGGGGGGGGGGGGGGGGGGGG4
400G00343434343333434343434343434343434343
30000033000000000000040003
40G000D0000000000G000D0003
30000033000000000000040003
334D4333334D43333333330003
330000330000003      30003
300GG0300G0G003      40004
300000030000003      30003
3000000200G000333333334D43333333333
3000000300G000300000000000000000003
3000000300G0003000000000000000000034443
3300003300000030043300000000003400D0G03
333333333333333003G00000000000G30030003
              3000000000000000000040004
              30000000G0G00000000030003
              30000000000000000000D0004
              30000000G0G00000000030003
              3000000000000000000040004
              3003G00000000000G30030003
              3004300000000000340040004
              3000000000000000000030003
              3000000000000000000040004
              3333333333333333333330003
                                  30003
                               11112D21111
                               20000000002
   1111111111111               10000000001
   1000000000001               20000000002
   1000000000001               10000000001
   10000G000G001               20000000002
   1000000000001               1000G00G001
   1000000000001               20000000002
   10011111111111111111111     11111D11111
   100D0000000000000000001       100001
   11110000000000000000001       100001
      10000000000000000001       100001
  11111000000000000111D1111111111100001
  1000D00G00000G00010000000000000000001
  1000100000000000010000000000000000001
  1000100000000000010000000000000000001
  111D111111D11111110000000000000000001
  1000000110G01    111D1111111111111111
  1000G00020002    133D34343433
  1000000G10001    300000000003
  1111111120002    400G00000004
    10S01 10G01    300000000003
    10001111D11    40000G000004
    10000000001    300000000003
    11111111111    343434343434

