NO ./textures/xpm/mossy.xpm
SO ./textures/xpm/greystone.xpm				

WE ./textures/xpm/wood.xpm

EA ./textures/xpm/eagle.xpm

F 81,81,81
C 120,120,120

111111111111111111
100000000111110001
100000000111000001
100000000011000001
100000000011000001
10000000N011000001
100000000000000001
100000000000000001
100000000000000001
100000000000000001
100000000000000001
111111111111111111
