NO ./textures/xpm/mossy.xpm
SO ./textures/xpm/greystone.xpm				
WE ./textures/xpm/512_wood.xpm
EA ./textures/xpm/eagle.xpm
D ./textures/xpm/eagle.xpm
F 81,81,81
C 120,120,120

111111111111111111
200000000111110001
100000000111000001
200000000011000001
100000000011000001
20000000N011000001
100000000000000001
200000000000000001
100000000000000001
200000000000000001
100000000000000001
321111111111111111
