NO ./textures/xpm/mossy.xpm
SO ./textures/xpm/greystone.xpm
WE ./textures/xpm/bluestone.xpm
EA ./textures/xpm/redbrick.xpm
D ./textures/xpm/wood.xpm

F 81,81,81
C 120,120,120

111111111111111111
100000000111110001
100000000111000001
100000000021000001
100000000011000001
10000000N011000001
100000000010000001
100000000020000001
100000000020000001
100000000010000001
100000000020000001
111111111111111111
