NO ./textures/hres_xpm/brick_german_flag.xpm
SO ./textures/hres_xpm/red_brick.xpm
WE ./textures/hres_xpm/red_brick.xpm
EA ./textures/hres_xpm/red_brick.xpm
D ./textures/hres_xpm/door.xpm

F 81,81,81
C 120,120,120

11111111111111111111111111111
100000000011000000000000D0001
101100000111000000G000001000111
1G0D000000D00000000000001000DG1
1D1100000111000000G000001000111
1001G100001100000111011110001
11110111111111011100000010001
1111D111111111011111D1111D111
11000000110101D111000111100G1
1000000000000GG01100011100011
1000N00000000GG0110G00D00001
11111111111111111111111111111
