NO ./path_to_the_north_texture
SO ./path_to_the_south_texture				

WE ./path_to_the_west_texture

EA ./path_to_the_east_texture



F 81,81,81
C 110,110,110

11111111111111111111111111111
10000000001100000000000000001
10110000011100000000000010001
10010000000000000000000010001
10110000011100000000000010001
10000000001100000111011110001
11110111111111011100000010001
11110111111111011101010010001
11000000110101011100000010001
10000000000000001100000010001
1000N000000000001100010000001
11111111111111111111111111111
