NO ./textures/hres_xpm/brick_german_flag.xpm
SO ./textures/hres_xpm/red_brick.xpm
WE ./textures/hres_xpm/red_brick.xpm
EA ./textures/hres_xpm/red_brick.xpm
D ./textures/hres_xpm/door.xpm

F 81,81,81
C 120,120,120

111111111111111111
100000000111110001
1111111D1111000001
1000000000D1000001
100000000011000001
10000000N011000001
100001000010000001
1000000000D0000001
1000000000D0000001
100000000010000001
1000000000D0000001
111111111111111111
