
NO ./textures/hres_xpm/red_brick.xpm
SO ./textures/hres_xpm/brick_german_flag.xpm
WE ./textures/hres_xpm/stones.xpm
EA ./textures/hres_xpm/woodd.xpm
F 81,81,81
C 120,120,120

   11111
   110E1
   11111