NO ./textures/hres_xpm/red_brick.xpm ./textures/hres_xpm/brick_german_flag.xpm  ./textures/hres_xpm/stones.xpm ./textures/hres_xpm/german_flag.xpm ./textures/hres_xpm/wrong_brick.xpm ./textures/hres_xpm/wood.xpm
SO ./textures/hres_xpm/red_brick.xpm ./textures/hres_xpm/brick_german_flag.xpm  ./textures/hres_xpm/stones.xpm ./textures/hres_xpm/german_flag.xpm ./textures/hres_xpm/wrong_brick.xpm ./textures/hres_xpm/wood.xpm
WE ./textures/hres_xpm/red_brick.xpm ./textures/hres_xpm/brick_german_flag.xpm  ./textures/hres_xpm/stones.xpm ./textures/hres_xpm/german_flag.xpm ./textures/hres_xpm/wrong_brick.xpm ./textures/hres_xpm/wood.xpm
EA ./textures/hres_xpm/red_brick.xpm ./textures/hres_xpm/brick_german_flag.xpm  ./textures/hres_xpm/stones.xpm ./textures/hres_xpm/german_flag.xpm ./textures/hres_xpm/wrong_brick.xpm ./textures/hres_xpm/wood.xpm
D ./textures/hres_xpm/door.xpm
F 81,81,81

111111111111111111111111111111111111111111111
1E00001000100000G0000000100000000010100000001
111D1D1D1010111D1D111D111D111D111010111011101
100010G01010101G10001000001010100000000011101
1010111D1111101D11111110101D11101111111111101
101010101000000000D000001D1000101000100011101
101110111111111110101111101011111110101011101
10101010001000001D100000100000101000001011101
101010101011101110111010111111101111111011101
1000001D1010000010000010101000100010000011101
101010101111111011101111101011111010111011101
101GD00G0000100000100000000000100000001011101
1110101011111011101D1010111011101111111111101
1010D0D00000001000001D10001000001000000011101
101G11101110101110101011111111101011111011101
1000D00000101000101D1G10000000100000101000001
101110111011101010111D10111011101110101011111
10100010001G101010000010001000100010101000001
1011101D101011101111101D111011111010101011011
101000101010001010001000001000101010100011011
101110101011101011101010111111101110111011011
101010101000001010000010001000100010101011011
101011101011111111101011111011101010101011011
100010001000100000001000100000101010101011011
101010111010101011111111101111101110101111011
101010100010101000000000001000001000100011011
101010111110111111111111101011111111111011011
1010100010100000D0000010001010000010000011011
1110111010111111101D1111101010101110111111011
100010000000100000101000100000101000000011011
10111111111D111010101D111111111D1111111011011
101000000010000010100000100000100010100011011
1110101011111D1110111110101111111010101011011
100010101000G01000000010101000001000101011011
101011101010111011111011101011101110101111011
101010001010100000100000100010000000100011011
1010101110101D1110111111111110101110101011011
1010100000101010100000G0000010100010001011011
101011111110101010111011111D10111011111011G11
10100000100010001010000000101010000000100D011
111111111111111111111111111111111111111111111