NO ./textures/hres_xpm/red_brick.xpm
SO ./textures/hres_xpm/brick_german_flag.xpm
WE ./textures/hres_xpm/stones.xpm
EA ./textures/hres_xpm/wood.xpm
F 81,81,81
C 120,120,120

111111
1N00000000000000000000000000000000000000000000000000000000000000000000000000000000000000000000000001
11111