NO ./textures/hres_xpm/red_brick.xpm ./textures/hres_xpm/brick_german_flag.xpm  ./textures/hres_xpm/stones.xpm ./textures/hres_xpm/german_flag.xpm ./textures/hres_xpm/wrong_brick.xpm ./textures/hres_xpm/wood.xpm
SO ./textures/hres_xpm/red_brick.xpm ./textures/hres_xpm/brick_german_flag.xpm  ./textures/hres_xpm/stones.xpm ./textures/hres_xpm/german_flag.xpm ./textures/hres_xpm/wrong_brick.xpm ./textures/hres_xpm/wood.xpm
WE ./textures/hres_xpm/red_brick.xpm ./textures/hres_xpm/brick_german_flag.xpm  ./textures/hres_xpm/stones.xpm ./textures/hres_xpm/german_flag.xpm ./textures/hres_xpm/wrong_brick.xpm ./textures/hres_xpm/wood.xpm
EA ./textures/hres_xpm/red_brick.xpm ./textures/hres_xpm/brick_german_flag.xpm  ./textures/hres_xpm/stones.xpm ./textures/hres_xpm/german_flag.xpm ./textures/hres_xpm/wrong_brick.xpm ./textures/hres_xpm/wood.xpm
D ./textures/hres_xpm/door.xpm
F 81,81,81
C 120,120,120

334343343434343333434343434343434343434343666666666666
300000D00G00000D0GGGGGGGGGGGGGGGGGGGGGGG0D000000000006
400G00343434343333434343434343434343434343666666666D66
30000033000000000000040003555555555555555555555555505555555555555555555555
40G000D0000000000G000D0003500000000000000000000000000000000000000000000005
300000330000000000000400035005050505050505050505050505050500000005555555D5
334D4333334D43333333330003500G0G0G0G0G0G0G0G0G0G0G0G0G0G0G0000000556543201
330000330000003      30003500505050505050505050505050505050000000540000002
300GG0300G0G003      40004500000000000000000000000000000000000000530000003
300000030000003      30003555555555555555555555555555555555555555521234565
3000000200G000333333334D43333333333
3000000300G000300000000000000000003
3000000300G0003000000000000000000034443
3300003300000030044000000000004400D0G03
333333333333333004G00000000000G40030003
              3000000000000000000040004
              30000000G0G000000000300036666666
              30000000000000000000D0000D0000G6
              30000000G0G000000000300036666666
              3000000000000000000040004
              3004G00000000000G40030003
              3004400000000000440040004
              3000000000000000000030003
              3000000000000000000040004
              3333333333333333333330003
                                  30003
                               11112D21111
                               20000000002
   1111111111111               10002020001
   1000000000001               20000000002
   1000000000001               10000000001
   10000G000G001               20002002002
   1000000000001               1000G00G001
   1000000000001               20000000002
   10011111111111111111111     11111D11111
   100D0000000000000000001       100001
   11110000000000000000001       100001
      10000000000000000001       100001
  11111000000000000111D1111111111100001
  1000D00G00000G0001010000000000000000166
  100010000000000001010000022G00220000DG6
  1000100000000000010D0000022000220000166
  111D111111D11111110100000000000000001
  1000000110G01    111D1111111111111111
  1000G00020002    133D34343433
  1000000G10001    300000000003
  1111111120002    400G00000004
    1S001 10G01    300000000003
    10001111D11    40000G000004
    1000D000001    300000000003
    11111111111    343434343434



